B                         GB                        
B                         GB
B                         GB
B                         GB
B                         GB
B                         GB
B                         GB
B                         GB
B BBBBLBBBBBBBBBBBBBBBBBL GB
B     L                 L GB
B     L                 L GB
B     L                 L GB
B     L                 L GB
B     L                 L GB
B     L                 L GB
BBBBBBBBBBBBBBBBBBBBBBBBBBBB
Gold:2,15
Gold:3,13
Monk:4,15
monk:5,15
monk:6,15
Hero:26,15

